11111111111111111111
10020000000000000221
10022002220000000021
10222222220000000001
12222222222222000001
12222222222222222001
10222222220002222001
10022220000002220001
10022220000002222001
10002200000222220001
10002200022222000201
10002222222220002221
12000222222220022221
12200000022220022221
12220000000222002221
11111111111111111111