11111111111111111111
10022222233300000221
10022002220100310021
10222222220000000001
12222222222222000001
12222222222222222001
10222222222222222001
10022222222222220001
10022222222222222001
10002222222222220001
10002222222222000201
10002222222220002221
12000222222220022221
12222222222220022221
12222222222222002221
11111111111111111111