11111111111111111111
13333333333333311111
13333333333331111111
13333333333333333331
13300000000000003331
13333333331111333331
13333333333111133331
13311333333311111111
13100000000000000031
13311333333333333331
13333333333333333331
11333333333311133331
11133333333331113331
11100000000000000031
11111333333111333331
11111111111111111111