11111111111111111111
13333333333333311111
13333333333331111111
13333333333333333331
13333333111133333331
13333333331111333331
13333333333111133331
13311333333311111111
13111133333333333331
13311333333333333331
13333333333333333331
11333333333311133331
11133333333331113331
11113333311111133331
11111333333111333331
11111111111111111111