11111111111111111111
10000002222222223311
10022222222222222231
10222222222222222221
10222112222220002221
12221111222000000221
12222112222220002221
12222222222222222221
12232211222222222221
12333332222222333321
13331133222223332221
12332222222333211001
12222222022222220001
12222220001122200001
12222000000000000001
11111111111111111111