11111111111111111111
11111111111111111111
11222222222222222211
11222222222222222211
11222112222220002211
11221111222000000211
11222333333320002211
11233333333333222211
11232211222222222211
11333332222222333311
11331133222223332211
11332222222333211011
11222222022222220011
11222220001122200011
11111111111111111111
11111111111111111111